<Level001><10><10>
<1111111111>
<1X1000000?>
<101?110011>
<1011111000>
<1000001001>
<10000?1001>
<1111011001>
<1000000001>
<1?0111000?>
<1111011111>